Garrydoolis=Garraí Dúlas
Annayalla=Eanaigh Gheala
Caucasus=Cugais
Jersey=Geirsí
Labrador=Labradar
Monday=Luan
glaochanna=glaonna
Arctic=An tArtach
Mohamed=Mahamad
Dane=Danar
statistic=staitistic
Inquisition=Cúistiúnacht
Tyrol=An Tioróil
Nazi=Naitsí
Athena=Aitéiné|Ataene
Sagitta=Saighde|Saighead
Littleton=An Baile Beag
Longford=An Longfort
Killybrone=Coillidh Brón
Kilmoyly=Cill Mhaoile
Anglophile=Gallbhách
Inishcarra=Inis Cara
Sharavogue=Searbhóg
agaidh=aghaidh
Glencar=Gleann Chárthaigh|Gleann an Chairthe
NuaGhaeilge=Nua-Ghaeilge
Drummin=An Dromainn
Ryefield=Achadh an tSeagail
Khufu=Cúfú
Punjab=An Phuinseaib
Menelaus=Meinealás
Templeogue=Teach Mealóg
Atlantic=An tAtlantach
Coolrain=Cúil Ruáin
Derrynacreeve=Doire na Criadh
Judas=Iúdás
Ceannain=Ceanainn
Ummoon=Iomún
diúltiú=diúltú
Shanlaragh=Seanlárach
Glinsk=Glinsce
Balkans=Na Balcáin|Na Stáit Bhalcánacha
Ceadaoine=Céadaoin
Donore=Dún Uabhair
Shanbally=An Seanbhaile
Garristown=Baile Gháire
Killygordon=Cúil na gCuirridín
aithine=aithne
Enlightenment=Eagnaíocht|Soilsiú
teilfíse=teilifíse
Mauretania=Mhúratáin
Recess=Sraith Salach
Meanus=Méanas
íochta=íoctha
Kilmichael=Cill Mhichíl
Rathlin=Reachlainn
athbreithniú=athbhreithniú
Murneen=Muirnín
Gurteen=Goirtín
Loki=Láca
Sahara=An Sahára
Beltane=Bealtaine
Clogh=An Chloch
Anascaul=Abhainn an Scáil
Lavagh=Leamhach
Bavaria=An Bhaváir
Bashkir=Baiscír
Speenoge=Spínnóg
Boynagh=Buíonach
tríchasach=tríchosach
speisiúl=spéisiúil
Latinist=Laidineoir
Kali=Cailí
Rahan=Raithean
Coolbaun=An Cúl Bán
Azores=Oileáin Asóir
téileamh=t-éileamh
Hippolyte=Hipilité
Killerrig=Cill Dheirge
Tangiers=Tainséir
Jenkinstown=Baile Sheinicín|Corclach
párliament=parlaimint
Tonyduff=An Tonnaigh Dhubh
fobairt=forbairt
Ballon=Balana
lehaon=le haon
Skull=An Scoil
Idun=Íodan
Tobago=Tobága
Brownsgrove=Ceathrú na Lathaí
bfhéidir=b'fhéidir
Down=An Dún
Hera=Héara|Héire
Macedonia=An Mhacadóin
Cuchulainn=Chúchulainn|Cúchulainn
Dundrum=Dún Droma
teilefís=teilifís
Torah=Tórá
spriocdáta=spriocdháta
Toormore=An Tuar Mór
Lyracrumpane=Ladhar an Chrompáin
Killashandra=Cill na Seanrátha
Moyvalley=Maigh Bhealaigh
Cortown=An Baile Corr
Islam=Ioslam
Balinderry=Baile an Doire
Antigone=Antagana
Glenroe=An Gleann Rua
Oldleighlin=Seanleithghlinn
Killateeaun=Coill an tSiáin
Furies=Fúire
Reykjavik=Réicivíc
Polyphemus=Polaiféamas
Bilboa=Biolbó
bhuil=bhfuil
Virgo=Maighdean
teaghmáil=teagmháil
Babylonia=An Bhablóinia
Mungret=Mungairit
cursíos=cur síos
Satyavan=Sáiteaván
Ballinfull=Baile an Phoill
Khentika=Ceintice
Knockagree=Cnoc na Graí
feidhmniú=feidhmiú
Doocastle=Caisleán an Dumha
Erris=Iorras
agur=agus
Delhi=Deilí
Soviet=Sóivéid
Bellacorick=Béal Átha Chomhraic
Dido=Díodó
Sark=Sairc
Kilclone=Coill Chluana
Iyneferty=Ínifirtí
Killadoon=Coill an Dúin
Pantheon=Paintéón
Svaldifari=Sualdafáraí
Moyne=An Mhaighean
Cloonloogh=Cluain Lua
Corbally=An Corrbhaile
Loughros=Luacharos
Basutoland=An Bhasútlainn
Kronos=Cronas
Tirida=Tiride
Cloverhill=Droim Caiside
Laggacurrer=Log an Churraigh
Cranford=Creamhghort
Hesperides=Heispirídí
Wrexham=Wrecsam
Dromard=An Droim Ard
Libra=Meá
Murntown=Baile Mhúráin
Menlough=Mionlach
Smarmore=Smearamair
Nuremberg=Nürnburg
Eti=Eití
Abyssinia=An Aibisín
cuimneamh=cuimhneamh
antábhachtach=an-tábhachtach
Peruvian=Peiriúch
Chapeltown=An Caol
Apocalypse=Apacailipsis
pictuir=pictiúr
Bracklyn=Breaclainn
Bree=Brí
Ballingarrane=Baile an Gharráin
antóir=an-tóir
Roundhead=Maolcheann
Vesuvius=Veasúiv
taispáint=taispeáint
Lattin=Laitean
Kilshane=Cill Sheáin
aigneachtaí=aighneachtaí
roint=roinnt
Inchigeelagh=Inse Geimhleach
Turkoman=Turcamáin
Chechnya=Seisnia
Bogota=Bogatá
Munster=Cúige Mumhan|Mumhain
núdarás=n-údarás
lehaghaidh=le haghaidh
Trinity=Tríonóid
aigneachta=aighneachta
Normanach=Normannach
Karelia=An Chairéil
Urhin=Iorthan
Appenines=Na hAipiníní
Newtownpark=Páirc an Bhaile Nua
xéareáise=xéaráise
Ardattin=Ard Aitinn
Causeway=An Tóchar
Blackwater=An Abhainn Dubh
Shanahoe=Seanchua
Oechalia=Éacail
Eyeries=Na hAoraí
Indian=Indiach Dearg
nimeachtaí=n-imeachtaí
Clifferna=An Chliaifearna
Cacus=Cacas
Tuesday=Máirt
Rathféigh=Ráth Faiche
tiochfaidh=tiocfaidh
August=Lúnasa|Mí Lúnasa
Cerberus=Ceirbearas
Merikare=Meireacara
Savitri=Saivitrí
agusan=agus an
anaus=anuas
Orion=Oiríon
Coolagherty=Cúil Uí Fhathartaigh
tréimse=tréimhse
Quakers=Cumann na gCairde
Arabia=An Araib
Madonna=Maighdean Mhuire
Whig=Fuig
timpeallac=timpeallacht
Banemore=An Bán Mór
cabidil=caibidil
Derreen=Doirín
Calcutta=Calcúta
Broadhaven=Cnocán na Líne
February=Feabhra|Mí Feabhra
Morocco=Maracó
Ghàidhlig=Ghaeilge na hAlban
Levant=An Leiveaint
Meenacross=Mín na Croise
Uzbek=An Úisbéiceastáin
Kilmurvy=Cill Mhuirbhigh
Micronesia=An Mhicrinéis
Pompeii=Poimpé
Amon-Re=Amón-Rá
Buri=Búirí
Baugi=Babhgaí
Pharao=Faró
reamhrádh=réamhrá
Mullan=An Muileann
Achill=Acaill
sábáilte=sábháilte
Wednesday=Céadaoin
Pantaloon=Pantalún
Sheean=An Sián
Clonalvy=Cluain Ailbhe
Bohermeer=An Bóthar Mín
Antarctic=An tAntartach
Eslingbridge=Droichead na hEislinne
Quilty=Coillte
Bosnia=An Bhoisnia
Moneygashel=Muine na gCaiseal
Hercules=Earcail|Heirciléas
Wellingtonbridge=Droichead Eoin
Strymon=Striomóin
Errigal=Earagail
Eurytus=Eoratas
Shillelagh=Síol Éalaigh
ionnanas=ionannas
cóireál=cóireáil
Kilronan=Cill Rónáin
Coke=Cóc
druite=druidte
Colmanstown=Baile Uí Chlúmháin
éirinn=Éirinn
Muscat=Muscáit
Rhodes=Ródas
Rinvyle=Rinn Mhaoile
tóstán=t-óstán
Garryfine=Garraí Phaghain
Pope=Pápa
Odysseus=Odaiséas
Indies=Indiacha
athbhlian=athbhliain
Abbeyleix=Mainistir Laoise
Derrynacaheragh=Doirín na Cathrach
Inishturk=Inis Toirc
lomairín=iomairín
chuichí=cluichí
Chuvashia=An tSuvais
Dolla=An Doladh
Breenagh=Na Bruíneacha
anamh=annamh
Ramsgrange=An Ghráinseach
coinceap=coincheap
Lissinagroagh=Lisín na gCruach
Glenmore=An Gleann Mór
Glenisland=Gleann Aoláin
polatúil=polaitiúil
Kong=Cong
Knockbrit=Cnoc an Bhriotaigh
Malayan=Malaech
Duagh=Dubháth
Eurytion=Eoratón
godriopásach=go driopásach
Drangan=Drongán
Cabragh=An Chabrach
Baluchistan=An Bhalúcastáin
Carracastle=Ceathrú an Chaisil
Carrowmore=Ceathrú Mhór Leacan
Knockanillaun=Cnoc an Oileáin
agu=agus
Coolea=Cúil Aodha
Hollyford=Áth an Chuilinn
bhFhlaitheas=bhFlaitheas
inscine=inscne
Saarland=Sárbruc
eicint=éigin
Laurasia=An Labhráise
borann=borrann
Ardnaree=Ard na Ria
Python=Píotón
speárbhean=spéirbhean
Lerna=Leirné
Saracen=Saraistín
Buryatia=Buiriáit
Berrings=Biorainn
Absolute=Absalóid
aimnigh=ainmnigh
compháirtíochta=comhpháirtíochta
Coole=An Chúil
Broomfield=Achadh an Bhrúim
fadbhanna=fadhbanna
Boherboy=An Bóthar Buí
Baghdad=Bagdad
Fivealley=An Chúirt
Milestone=Cloch an Mhíle
Glenade=Gleann Éada
Gallimh=Gaillimh
fondúireac=fondúireacht
cailte=caillte
Loughlinn=Loch Glinne
iniúctha=iniúchta
Clonegall=Cluain na nGall
Ardlougher=Ard Luachra
Bactria=Baictria
innu=inniu
Phoenicia=An Fhéiníc
Christendom=Críostaíocht
Auriga=Ara
Killinardrish=Cill an Ard-dorais
Antiope=Antaipé
aimneacha=ainmneacha
Authun=Abhtan
Cinderella=Luaithríona
Pleiades=An Phléadach|An Streoillín|An Tréidín|An tÉillín
Jehovah=Iáivé
naisceanna=naisc
Spiddle=An Spidéal
Dartrey=Dartraí
Sraheens=Na Sraithíní
Newmills=An Muileann Úr
néireodh=n-éireodh
Reananerree=Rae na nDoirí
Coolcullen=Cúl an Chuilinn
Charybdis=Cairíbdis
Abdera=Aibdéire
Ruan=An Ruán
Cothon=Cotón
núsáid=n-úsáid
tháing=tháinig
Taurus=Tarbh
Shrovetide=Inid
Thames=An Tamais
Anglesborough=Gleann na gCreabhar
uasdhátú=uasdátú
Teerelton=Tír Eiltín
aran=ar an
Andersonstown=Baile Andarsan
Keel=An Caol
Downies=Na Dúnaibh
Kenamun=Ceineaman
Kilmore=Cill Mhór
Guadeloupe=Guadalúip
Glanworth=Gleannúir
Holycross=Baile na gCailleach
Pegasus=Peigeasas
Killann=Cill Anna
Eucharist=Eocairist
fen=faoin
Demeter=Déiméatar
comphobal=comhphobal
Kilroosky=Coill na Rúscaí
Doohamlat=Dúthamhlach
Lyceum=Licéam
dóthin=dóthain
coinníolacha=coinníollacha
titithe=tite
ars'an=arsa an
Gaelgeoirí=Gaeilgeoirí
Aclare=Áth an Chláir
Attymon=Áth Tíomáin
oscalit=oscailt
Cloghjordan=Cloch Shiurdáin
neagraíochtaí=n-eagraíochtaí
Tasmania=An Tasmáin
Dooagh=Dumha Acha
Killadysert=Cill an Dísirt
Granagh=Greanach
Dovea=An Dubhfhéith
Chrommyum=Cróimiam
Mornington=Baile Uí Mhornáin
náisúnta=náisiúnta
Chair=Cathaoirleach
Ballinacurra=Baile na Cora
Milltownpass=Bealach Baile an Mhuilinn
Comptroller=Ard-Reachtaire
ríathair=rínathair
soléir=soiléir
Carrickboy=An Charraig Bhuí
feidhmeanmach=feidhmeannach
Vice-Chancellor=Leas-Seansailéir
Oedipus=Éideapús
Narmer=Narmar
amhráinni=amhráin
Crimea=An Chrimé
Burren=Boirinn
statisticí=staitisticí
Tashkent=Taiscint
Karakalpak=Cara-Chalpáic
Proteus=Próitéas
Knockainy=Cnoc Áine
Leitrim=Liatroim
Killegar=Coill an Ghairr
Muhammed=Mahamad
Derryvohy=Doire Bhoithe
Gaedhael=Gael
Malin=Málainn
Mullaghmore=An Mullach Mór
inadhiaidh=ina dhiaidh
Rathlee=Ráth Lao
Kilmacud=Cill Mochuda
Gorteeny=Goirtíní
difiriúil=difriúil
Kilmanahan=Cill Mainchín
Drumakill=Droim na Coille
Feiriste=Feirste
Tallonstown=Baile an Tallúnaigh
Galbally=An Gallbhaile
Turlough=Turlach
oidreachta=oidhreachta
Kesh=An Chéis
January=Eanáir|Mí Eanáir
Kilmanagh=Cill Mhanach
Rylane=Réileán
Cleristown=Baile de Cléir
Habháís=Haváis
Artemis=Artaimís
Hindustan=Hiondustáin
babhtha=babhta
Venus=Véineas
Gortgarrigan=Gort Geargáin
Louvain=Lováin
Barnesmore=An Bearnas Mór
Antioch=Aintíoc
Clarina=Clár Aidhne
Pentateuch=Peintiteoch
Bealin=Béal Linne
Yama=Iáma
Glantane=An Gleanntán
Lawderdale=Droim Raithin
tam=t-am
Shangarry=An Seangharraí
Nurney=An Urnaí
Doonogan=Dún Ógáin
Doomsday=Lá an Bhreithiúnais|Lá an Bhrátha|Lá an Luain|Lá an tSléibhe
Orthrus=Ortras
Eurasia=An Eoráise
Spa=An Spá
Kilbrogan=Cill Brógáin
Tahiti=Taihítí
Advent=Aidbhint
Millford=Baile na nGallóglach
Himalayas=Himiléithe
Hague=An Háig
Aghnamullen=Achadh na Muilleann
Ossian=Oisín
fluich=fliuch
Yugoslavia=An Iúgslaiv
Pentecost=An Chincís
Lauragh=An Láithreach
Kylebrack=An Choill Bhreac
Whitsun=An Chincís
Beltra=Béal Trá
Clontallagh=Cluain tSalach
Stranoodan=Sraith Nuadáin
Gortnahoo=Gort na hUamha
cirghe=éirí
Sofia=Sóifia
Majorca=Mallarca
Eabharc=Eabhrac
chuna=chun a
Drumfree=Droim Fraoigh
grammadach=gramadach
Eirinneach=Éireannach
Tatar=Tatair
Sinai=Síonáí
Martinstown=Baile Mháirtín
Italic=Iodáilic
Crusade=Cogaí na Croise
Capewell=Tobar an Chaipín
isea=is ea
Laragh=Láithreach
Sabbath=Sabóid
Cloghboley=Clochbhuaile
agusna=agus na
Neptune=Neiptiún
Bellanamore=Béal an Átha Móir
Killasser=Cill Lasrach
Newfield=An Pháirc Nua
túdarás=t-údarás
Scylla=Sciolla
Stroove=An tSrúibh
Cassiopeia=Caiseoipé
Carrickroe=An Charraig Rua
Feinne=Fiann
Castlecoote=Baile Mhic Oireachtaigh
Hillstreet=Leac na gCon
Hispaniola=Easpáinneoil
Cíochóité=Cíochótae
Rathcool=Ráth Cúil
ofigiúil=oifigiúil
cumacht=cumhacht
Irishwoman=Gael
Egyptology=Éigipteolaíocht
Ballindangan=Baile an Daingin
cinlae=cín lae
Rosary=Coróin Mhuire
Togher=An Tóchar
Kilcolman=Cill Cholmáin
Argonaut=Arganát|Argónátach
Gola=Gabhla
Nohaval=Nuachabháil
anbhuíoch=an-bhuíoch
Ferrybank=Port an Chalaidh
Killavil=Cill Fhábhail
Fermanagh=Fear Manach
Inchicore=Inse Chór
Romulus=Rómalas
Tawny=An Tamhnaigh
einne=aon duine
Maddockstown=Baile Mhadóg
Areopagus=Cnoc Airéis
Raheen=An Ráithín
Parcae=Pairche
Bennekerry=Binn an Choire
Bunane=An Bunán
Porturlin=Port Durlainne
Offaly=Uíbh Fhailí
bliantiúil=bliantúil
Samaria=An tSamáir
Coca-Cola=Cóc
Currabeha=An Chorr Bheithe
leabharín=leabhairín
Kilrean=Cill Riáin
Trion=An Trian
Achonry=Achadh Conaire
Knockmore=An Cnoc Mór
adhmhála=admhála
Tallow=Tulach an Iarainn
Dunlewy=Dún Lúiche
Coolderry=Cúl Doire
Crosserlough=Crois ar Loch
Orangeman=Fear Buí
d'thoil=do thoil
Cornwall=Corn na Breataine
Greenanstown=Baile Uí Ghrianáin
Aghagower=Achadh Ghobhair
Glentogher=Gleann Tóchair
Titan=Tíotán
Reformation=Reifirméisean
Carrowmenagh=Ceathrú Meánach
Gaelgeoir=Gaeilgeoir
Doonsallagh=Dún Salach
Kilranelagh=Cill Rannaileach
beathnaiséisí=beathaisnéisí
túrscéalaí=t-úrscéalaí
Aquila=Iolar
Newtowncunningham=An Baile Nua
Killucan=Cill Liúcainne
Carran=An Carn
Eve=Éabha
neamsheasmhach=neamhsheasmhach
Moyglass=Maigh Ghlas
Cullahill=An Chúlchoill
Lent=Carghas
coirpideachas=corpoideachas
Inisheer=Inis Oírr
Maganey=Maigh Géine
Amulius=Amúileas
Feenagh=Fíonach
mileanna=milleanna
Santiago=Saintiagó
nathruithe=n-athruithe
mBoston=mBostún
Muhammad=Mahamad
Tomhaggard=Teach Moshagard
Corrandrum=Cor an Droma
Brandrum=Bréandroim
Cloghbrack=An Chloch Bhreac
Cupid=Cúipid
Knocknagashel=Cnoc na gCaiseal
gombeadh=go mbeadh
Ballinagleragh=Baile na gCléireach
Bahamas=Na Bahámaí
Suomi=An Fhionlainn
Clontuskert=Cluain Tuaiscirt
comhgairdeachas=comhghairdeas
Castlerickard=Caisleán Riocaird
specialta=speisialta
Sennedjem=Seinnidim
foghlam=foghlaim
afháil=a fháil
assin=as sin
Letterbarra=Leitir Beara
Albion=An Bhreatain
Somaliland=An tSomáil
Garranlahan=An Carrán Leathan
anmhór=an-mhór
Corrawaleen=Corr an Mhailín
bhfui=bhfuil
Juno=Iúnó
Trinidad=Oileán na Tríonóide
Abbey=An Mhainistir
Moneystown=An Muine
Admete=Aidméité
Kilconly=Cill Chonla
Kilmacrah=Cill Mhic Craith
haithle=aithle
choích=choíche
Ladysbridge=Droichead na Scuab
n'eiri=n-éirí
Brinlack=Bun na Leaca
dtína=dtí na
Polydeuces=Polaideoicéis
Kilrane=Cill Ruáin
adhéanamh=a dhéanamh
Autonoe=Átanae
alún=talún
Rover=Ródaí
Internet=Idirlíon
Hyllus=Hilleas
Scotch=Na hAlbanaigh
Fedamore=Feadamair
Templeshanbo=Teampall Seanbhoth
ngíomh=ngníomh
cinnitú=cinntiú
Cygnus=Cros an Tuaiscirt|Eala
Knockdrin=Cnoc Droinne
Caheragh=Cathrach
Loghill=Leamhchoill
Pleiads=An Phléadach|An Streoillín|An Tréidín|An tÉillín
Bulgaden=Builgidín
Europe=An Eoraip|Mór-Roinn
deirneach=deireanach
Ovens=Na hUamhanna
Kilmorna=Coill Mhaonaigh
agsu=agus
bliadain=bliain
Greenan=An Grianán
Carrowroe=An Cheathrú Rua
Askamore=An Easca Mhór
Brownstown=Baile an Bhrúnaigh
Ellistrin=Eileastran
pagh=pá
Rochestown=Baile an Róistigh
todchaí=todhchaí
tairring=tarraing
Losset=An Losaid
Aeinéas=Aenéas
feách=féach
Cleito=Cléató
Mohammad=Mahamad
Kilflyn=Cill Flainn
Boherlahan=An Bóthar Leathan
Barnatra=Barr na Trá
Castile=An Chaistíl
arfáil=ar fáil
Tuosist=Tuath Ó Siosta
Russophile=Rúisbhách
ariam=riamh
achinntiú=a chinntiú
afheabhsú=a fheabhsú
Killeagh=Cill Ia
Wight=Iocht
Tievemore=Taobh Mór
Scandinavia=Lochlainn
Tyrone=Tír Eoghain
Srah=An tSraith
Ljubljana=Liúibleána
Curraglass=Cora Ghlas
nGàidhlig=nGaeilge na hAlban
Capparoe=An Cheapach Rua
feacail=feiceáil
Saxony=An tSacsain
Cloonminda=Cluain Mionda
Laurencetown=An Baile Mór
Moneygold=Muine Dhúltaigh
Drumbane=An Drom Bán
Koran=Córan
cairdúil=cairdiúil
nadaoine=na daoine
Michaelmas=Lá Fhéile Michíl
araghaidh=ar aghaidh
Bootes=Aoire
Clogher=An Clochar
Byzantium=An Bhiosáint
tatmaisféar=t-atmaisféar
Lucifer=Lúicifir
tábhar=t-ábhar
naistriú=n-aistriú
pictuirí=pictiúir
Hollycross=Mainistir na Croiche
Ballinunty=Baile an Fhantaigh
tsort=sórt
Bellough=Béal Lathaí
iarrtas=iarratas
oscalite=oscailte
coma=corna
Linos=Lineas
Persephone=Peirseifine
Ravensdale=Gleann na bhFiach
Bithynia=An Bhitín
Antaeus=Antaes
Rangoon=Rangún
Theseus=Téiséas
Culleens=Na Coillíní
dhruite=dhruidte
ainilís=anailís
Durrow=Darú
Owey=Uaigh
Hindu=Hiondúch
Camp=An Com
Rumania=An Rómáin
Castlefinn=Caisleán na Finne
asa=as a
Mordovia=An Mhordóiv
crannn=crann
imo=i mo
Easter=Cáisc
comisinéara=coimisinéara
Nereus=Néiréas
Leckemy=Leic Éime
feicail=feiceáil
Colchis=Coilcís
ladh=1ú
arfad=ar fad
Atlantis=Atlantas
comisiún=coimisiún
corpoideadchas=corpoideachas
alán=a lán
Kilcarn=Cill an Chairn
arsa'n=arsa an
Andromeda=Andraiméide
fa=faoi
Dunnamaggan=Dún Iomagáin
Geryon=Géarón
adhmháil=admháil
máithair=máthair
tóstóir=t-óstóir
Knockbrack=An Cnoc Breac
Killinierin=Coill an Iarainn
Kinvarra=Cinn Mhara
churar=chur ar
gac=gach
Antichrist=Ainchríost
Castletown=Baile an Chaisleáin
colas=eolas
Ariadne=Airianna
Clongoweswood=Coill Chluana Gabhann
agusín=aguisín
Inishcrone=Inis Crabhann
Drumgeely=Drom Gaibhle
Madabawn=An Maide Bán
Greencastle=An Caisleán Nua
Styx=Stiocs
Talibaan=Talaban
Remus=Réamas
foglaim=foghlaim
Hinduism=Hiondúchas
lonsaí=ionsaí
lenan-áirítear=lena n-áirítear
nintinn=n-intinn
Peterswell=Tobar Pheadair
Kilcullen=Cill Chuillinn
ThuaidhTheas=Thuaidh-Theas
Coolcarrigan=Cúil Charraigín
athabhairt=a thabhairt
Napoleon=Napóilean
abhaineann=a bhaineann
Brierfield=An Driseachán
Danesfort=Dún Feart
Gobi=Góibí
Nakhichevan=An Nacaiseaváin
Drumcolliher=Drom Collachair
Gaothdobhair=Gaoth Dobhair
roime=roimhe
Ulysses=Uiliséas
afhorbairt=a fhorbairt
isé=is é
Nauruan=Nárúch
Artaine=Ard Aidhin
Antarctica=An Antartaice
Aeolus=Aeólas
Ballinasloe=Béal Átha na Sluaighe
Hephaestus=Héafaestas
Crete=An Chréit
Moldavia=An Mholdáiv
anbhródúil=an-bhródúil
Newinn=Loch Ceann
Cloonyquin=Cluain Uí Choinn
Monasterboice=Mainistir Bhuithe
talann=tallann
Doohooma=Dumha Thuama
Attimachugh=Ait Tí Mhic Aodha
neiri=n-éirí
Gaelige=Gaeilge
Indus=An Iondúis
Dromina=Drom Aidhne
infrastruchtúr=infreastruchtúr
Russifying=Rúisiú
Carthage=An Chartaig
Yakutsk=Iacútsc
Hapy=Hapaí
macnamh=machnamh
Fordstown=Baile Forda
Srahmore=An Srath Mór
achmhainne=acmhainne
Curreeny=Na Coirríní
Grousehall=Maigh Leacht
Convoy=Conmhaigh
Megara=Meigeara
Archbishop=Ard-Easpag
Omphale=Omfailé
Bellananagh=Béal Átha na nEach
suimúil=suimiúil
Ceryneia=Cheirin
Doogort=Dumha Goirt
Whiteboy=Buachaill Bán
Glasthule=Glas Tuathail
neirí=n-éirí
Connaught=Connacht
Commons=Na Coimíní
Kosovo=Cosaiv
Gàidhlig=Gaeilge na hAlban
Utopia=Útóipe
Abkhazia=An Abcáis
Glenflesk=Gleann Fleisce
Ashwapati=Aiseapaití
Butlerstown=Baile an Bhuitléaraigh
Minoa=Mionó
Toomyvara=Tuaim Uí Mheára
Tullycoe=Tulaigh Chuach
ambeidh=a mbeidh
Ringville=An Rinn
Fenian=Fínín
Drum=An Droim
Bohemia=An Bhoihéim
Madeira=Maidéara
tughta=tugtha
Tsar=Sár
Babel=Báibil
Colehill=Cnoc na Góla
eolaíchta=eolaíochta
Ballinalack=Béal Átha na Leac
Belisarius=Beileasáirias
Errislanan=Iorras Fhlannáin
Olympics=Cluichí Oilimpeacha
Bofeenaun=Both Faonáin
Tunis=Túinis
Carrahan=Carrachán
Medea=Méidia
Zeus=Séas
ríomhpost=ríomhphost
nábhar=n-ábhar
Manila=Mainile
Pollux=Pollacs
Bogay=Both Ghé
Carrowbeby=Ceathrú Bheithí
Ganymede=Ganaiméide
cathar=cathair
Meirceánach=Meiriceánach
Archerstown=Baile an Airsirigh
Belclare=Béal Chláir
Dunamon=Dún Iomáin
anchuid=an-chuid
Tubber=An Tobar
oifigúil=oifigiúil
measíní=meaisíní
Wikinews=Vicínuacht
Zionist=Siónaí
riomphoist=ríomhphoist
gaeltacht=Gaeltacht
sciomram=sciomraím
Shanagolden=Seanghualainn
Persia=An Pheirs
Chiron=Céarón
tiomlán=t-iomlán
Centaur=Ceinteár
Menes=Míníos
Gaelicizing=Gaelú
Glasleck=Glasleic
Autolycus=Átailíceas
flaithiúl=flaithiúil
Killyneill=Coill Uí Néill
Faha=Faiche
Czar=Sár
Tooreen=An Tuairín
infrastruchtur=infreastruchtúr
Inishmaan=Inis Meáin
Querrin=An Cuibhreann
Esker=An Eiscir
bhaineannle=bhaineann le
Saturn=Satarn
Mogeely=Maigh Dhíle
Castleblakeny=Gallach
China=An tSín
Cecilstown=Baile an Bhriotaigh
Clones=Cluain Eois
Bretagne=An Bhriotáin
Sobek-Re=Sobac-Rá
bhaintamach=bhaint amach
corfhocal=corrfhocal
Gàidhlige=Gaeilge na hAlban
cummanach=cumannach
Kilgobnet=Cill Ghobnait
Cuilmore=An Choill Mhór
Osiris=Óisíris
leisan=leis an
Drumanespick=Droim an Easpaig
Messiah=Meisias
figúirí=figiúirí
Augean=Áigéis
Rathmines=Ráth Maonais
Freshford=Achadh Úr
Tanganyika=An Tangainíc
Knockraha=Cnoc Rátha
Astrakhan=An Astracáin
Pisidia=An Phisid
Corlismore=Corrlios Mór
Corrofin=Cora Finne
Latinity=Laidineacht
polatíocht=polaitíocht
Jutland=An Iútlainn
Kazakstan=An Chasacstáin
Coolkenna=Cúil Uí Chionaoith
Correllstown=Baile Mhic Cearúill
Aherlow=Eatharlach
chonachtas=chonacthas
neamhghlaolmhara=neamhghaolmhara
June=Meitheamh|Mí an Mheithimh
Hellenist=Gréagóir|Heilléanaí
forum=fóram
Boyounagh=Buíbheanach
dfhógair=d'fhógair
Tullycoly=Tulaigh an Chuaille
Gilgamesh=Giolgamais
d'féadfadh=d'fhéadfadh
Latin=Laidin
institiúd=institiúid
Mastergeehy=Máistir Gaoithe
Lammastide=Lá Lúnasa
Connamara=Conamara
Ballinagar=Béal Átha na gCarr
Kiltiernan=Cill Tiarnáin
Fortel=Foirtil
glorthaí=glórtha
Timor=Tíomór
Creegh=An Chríoch
England=Sasana
Glenville=Gleann an Phréacháin
Glanlough=Gleann Locha
Bhutan=An Bhútáin
achmainn=acmhainn
Taleban=Talaban
Kylemore=An Choill Mhóir
Tartary=An Tartair
Piedmont=Píodmant
Barnycarroll=Bearna Chearúill
Electra=Éileictre
Hawaii=Haváí
morais=mór-ais
Kilmacsimon=Coill Mhic Shíomoin
neamh-achmainn=neamhacmhainn
Tulrohaun=Tulach Shrutháin
Amsterdam=Amstardam
Annunciation=Teachtaireacht an Aingil
Nazareth=Nasaireit
Waterfall=Tobar an Iarla
meastú=meas tú
Mass=Aifreann
níosmó=níos mó
Derrylane=Doire Leathan
Clonroadmore=Cluain Ráda
Astarte=Astarta
Bechuanaland=An Bheachuanlainn
Reens=Roighne
Cloontia=Na Cluainte
Keimaneigh=Céim an Fhia
Morpheus=Moirféas
Glenboy=Gleann Buí
Sanskrit=Sanscrait
déirigh=d'éirigh
Monilea=An Muine Liath
Achaean=Acaech
Rathgormuck=Ráth Ó gCormaic
Siberia=An tSibéir
Hades=Háidéas
adhéanann=a dhéanann
ceistenna=ceisteanna
Summerhill=Cnoc an Línsigh
Donadea=Domhnach Dheá
mionshonraí=mionsonraí
Jupiter=Iúpatar
Carlow=Ceatharlach
buachail=buachaill
Crossdoney=Cros Domhnaigh
Kinshasa=Cinseasa
Boghadoon=Both an Dúin
Roman=Rómhánach
oirúnach=oiriúnach
Hydra=Hiodra
Dowth=Dubhadh
scátheagra=scátheagraíocht
Saar=Sár
Killenagh=Cill Éanach
Drummullin=Droim an Mhuilinn
fadbhreathnaiteach=fadbhreathnaitheach
ostáin=óstlainne|óstlanna
Kilbarry=Cill Barra
Ballindoon=Baile an Dúin
bealtaine=Bealtaine
Friday=Aoine
Termon=An Tearmann
Inishboffin=Inis Bó Finne
Cappagh=An Cheapaigh
Coolock=An Chúlóg
Drung=Drong
suimiúl=suimiúil
Clonakenny=Cluain Uí Chionaoith
Erythia=Eirit
nac=nach
bhíuil=bhfuil
Cepheus=Ceiféas
Mayfield=Baile na mBocht
Leinster=Cúige Laighean
Tobercurry=Tobar an Choire
Brannockstown=Baile na mBreatnach
Dagestan=An Dagastáin
Sicily=An tSicil
comisiúin=coimisiúin
Bellanaboy=Béal Átha na Buí
Baleares=Na hOileáin Bhailéaracha
Germanic=Gearmáinic
Gondwanaland=Gonduanalainn
Rathangan=Ráth Iomgháin
Phibsborough=Baile Phib
Gortaroo=Gort an Rú
Bradocks=Na Bráideoga
Ceylon=An tSiolóin
Silesia=An tSiléis
Coolegreane=Cúl le Gréin
diuitethe=diúitéithe
cadé=cad é
céana=céanna
Halloween=Oíche Shamhna
Fingal=Fine Gall
dea-boladh=dea-bholadh
Chuvash=An tSuvais
Proserpine=Proiseirpine
doicméad=doiciméad
Kiribati=Cireabaití
Cloonkeevy=Cluain Ciabhaigh
ao'chor=aon chor
Cloonfallagh=Cluain Falach
aris=arís
Friesland=An Fhreaslainn
Aeacus=Aecas
Rathcore=Ráth Cuair
Glenmaquin=Gleann Mhic Coinn
larua=iaró
Chronos=Cronas
Drumandoora=Drom an Dúdhoire
polataíocht=polaitíocht
toideachas=t-oideachas
Stackallan=Stigh Colláin
Dromin=Droim Ing
gaeltachtaí=Gaeltachtaí
Guinea-Bissau=Guine Bhissau
Glenbrien=Gleann Bhriain
oiriúnt=oiriúint
Aghinagh=Achadh Fhíonach
feach=féach
Lobinstown=Baile Lóibín
Robertstown=Baile Riobaird
tádh=t-ádh
O'Briensbridge=Droichead Uí Bhriain
Annestown=Bun Abha
Garranabraher=Garrán na mBráthar
Currane=An Corrán
Ostend=Ostainn
aleanas=a leanas
Cloonlara=Cluain Lára
aguis=agus
Brurec=Brú Rí
Pettigoe=Paiteagó
tionscamh=tionscnamh
coiteanta=coitianta
Ballaghkeen=An Bealach
Longwood=Maigh Dearmhaí
Stonyford=Áth Stúin
Lixnaw=Leic Snámha
infhilte=infhillte
tuaslaóir=tuaslagóir
Famine=Drochshaol|Gorta Mór
Clonmore=Cluain Mhór
Scorpio=Scairp
Cloonagh=Cluain Each
leissin=leis sin
comphobail=comhphobail
Meenbannad=Mín Beannaid
Mauricemills=Muilte Mhuiris
Apollo=Apaill|Apolló
Turbot=Tairbeart
innui=inniu
Kincaslough=Cionn Caslach
Malay=Malaech
aus=agus
Glencolumkille=Gleann Cholm Cille
túdar=t-údar
Cappadocia=An Chapadóic|Chapadóic
Khefre=Ceafra
Perseus=Peirséas|Pheirséis
Killavally=Coill an Bhaile
Drumree=Droim Rí
Meenaneary=Mín an Aoire
seachtainiúl=seachtainiúil
lelinn=le linn
Fairymount=Mullach na Sí
Unionist=Aontachtaí
October=Deireadh Fómhair|Mí Dheireadh Fómhair
Dooega=Dumha Éige
Stillorgan=Stigh Lorgan
Tirol=An Tioróil
Vatican=An Vatacáin
Templederry=Teampall Doire
agna=ag na
Ural=An Úrail
chunna=chun na
Moyasta=Maigh Sheasta
Manetho=Manató
Pallas=Pailís
Strand=An Trá
Herdsman=Aoire
abheith=a bheith
Garvagh=Garbhach
Ballinlough=Baile an Locha
Geailge=Gaeilge
Emo=Ioma
fadthéarmach=fadtéarmach
Moyvore=Maigh Mhórdha
Epiphany=Eipeafáine|Lá Chinn|Lá Nollag Beag
denamh=déanamh
Derrada=Doire Fhada
Tourmakeady=Tuar Mhic Éadaigh
Caomhín=Caoimhín
Ballinaclashet=Baile na Claise
Curraghboy=An Currach Buí
Lyra=Lir
Devil=An Boc Dubh|An Fear Mór|An Fear Thíos|An Giolla Goillín|An Mac Mallachta|An Seanbhoc|An Seanbhuachaill|An buachaill críonna|An fear dubh|An tAinspiorad|An tÁibhirseoir|Fear an Uabhair
Babylon=An Bhablóin
Chernobyl=Searnóbail
Iole=Iailé
Duamutef=Duamútaf
Zululand=Súlúlainn
April=Aibreán|Mí Aibreáin
Fennor=Fionnúir
Bosporus=An Bosparas
Ballaghnatrillick=Béal Átha an Trí Liag
Welchtown=Baile na mBreatnach
Bothermore=An Bóthar Mór
Inishkeen=Inis Caoin
Monkstown=Baile an Mhanaigh|Baile na Manach
doicméid=doiciméid
Anglo-Irishman=Gall-Ghael
nais=n-ais
Triton=Tríotón
said=siad
tháining=tháinig
Cashelgarran=Caiseal an Ghearráin
leisna=leis na
Mesopotamia=An Mheaspatáim
aigneacht=aighneacht
Cloondaff=Cluain Damh
Drumfin=Droim Fionn
Tonregee=Tóin re Gaoth
d'aineoinn=d'ainneoin
teaglaigh=teaghlaigh
Gortymadden=Gort Uí Mhadaín
annocht=anocht
Cashelmore=An Caiseal Mór
Clonkeen=Cluain Chaoin
tradisiúnta=traidisiúnta
Derrybrien=Daraidh Braoin
Mercury=Mearcair
Goidel=Gael
Canterbury=Cantarbaraí
fuarathas=fuarthas
Afro-Asiatic=Afra-Áisic
Cornafean=Corr na Féinne
Scots=Béarla na hAlban
Templeglentan=Teampall an Ghleanntáin
finiméin=feiniméin
Haystown=Carn Ulfa
Grangeford=An Ghráinseach
Drummacool=Droim Mhic an Choill
Sagittarius=Saighdeoir
Kildare=Cill Dara
nabliana=na bliana
Rathkenny=Ráth Cheannaigh
Reanascreena=Rae na Scríne
Kilworth=Cill Uird
sruchtúr=struchtúr
Evenus=Eivinis
Aquarius=Iompróir an Uisce|Uisceadóir
Donnycarney=Domhnach Cearna
Lanesborough=Béal Átha Liag
ngairthí=ngairtí
Drumeague=Droim Éag
tainm=t-ainm
amlaidh=amhlaidh
comisinéir=coimisinéir
pictúir=pictiúr
gael=Gael
Canadian=Ceanadach
Bantu=Bantúch
Emlaghmore=An tImleach Mór
Wilkinstown=Baile Uilcín
Pluto=Plútón
Beograd=Béalgrád
Clouncagh=Cluain Cath
Templeboy=Teampall Baoith
Gormanston=Baile Mhic Gormáin
Wikipedian=Vicipéideoir
Knockvicar=Cnoc an Bhiocáire
Rathmullen=Ráth an Mhuilinn
Ballinabrackey=Buaile na Bréachmhaí
illdaite=ildathach
Zeeland=An tSéalainn
leisean=leis-sean
néiríonn=n-éiríonn
Annagary=Anagaire
tre=trí
sina=sin a
samradh=samhradh
Donaghmoyne=Domhnach Maighean
Charioteer=Ara
Strahart=Sraith Airt
oidreacht=oidhreacht
Kilmaganny=Cill Mogeanna
Caher=An Chathair
másé=más é
Dromkeen=Drom Caoin
Colbinstown=Baile Choilbín
Gaelicization=Gaelú
noidhreacht=n-oidhreacht
Castleshane=Caisleán an tSiáin
Moluccas=Molacaí
tabairt=tabhairt
Kiltormer=Cill Tormóir
aimisigh=aimsigh
agá=ag a
Callow=An Caladh
Bartlemy=Tobar Pártnáin
March=Márta|Mí an Mhárta
fe=faoi
Samoan=Samóch
Bellnamullia=Béal Átha na Muille
Zulu=Súlú
Elton=Eiltiún
Indochina=An Ind-Sín
inaghaidh=in aghaidh
Sirius=Réalta an Mhadra
Fore=Baile Fhobhair
Thursday=Déardaoin
Appalachians=Na Sléibhte Apaláiseacha
Faroese=Faróch
Bunnyconnellan=Muine Chonalláin
Capricorn=Gabhar
Anguilla=Angaíle
Ballinard=Baile an Aird
Brideswell=Tobar Bríde
suimuil=suimiúil
achh=ach
Francophone=Frainciseoir
Ladon=Ladóin
Britain=An Bhreatain
Cancer=Portán
Loughan=Lochán
Crossmaglen=Crois Mhic Lionnáin
Janesboro=Baile Shinéad
Elysium=Tír na nÓg|Éilísiam
tiarratasóir=t-iarratasóir
laethaenta=laethanta
Dia's=Dia is
Saturday=Satharn
Muckross=Mucros
Brussels=An Bhruiséil
Borris=An Bhuiríos
gailge=Gaeilge
Clogheen=An Chloichín
Byelorussia=An Bhealarúis
Gaeilgoir=Gaeilgeoir
Kilshanny=Cill Seanaigh
Scythia=Scitia
Dover=Dobhar
Leonidas=Leonadas
Navajo=Navachóch
nn=ann
Christmas=Lá Nollag|Nollaig
Barbary=An Bharbair
Drumcondra=Droim Conrach
Doohat=Dútháite
Rhone=An Róin
Charon=Carán
aistharraing=aistarraing
Kurdistan=An Chordastáin
Nofret=Nofrat
gaeltachta=Gaeltachta
Park=An Pháirc
Rathdrum=Ráth Droma
nuaaimseartha=nua-aimseartha
Fybagh=An Fhadhbach
nachbhfuil=nach bhfuil
Foxfield=Cnocán an Mhada Rua
Narcissus=Nairciseas
achmhainn=acmhainn
Brickeens=Na Broicíní
Poles=Na Pollaí
Byblos=Bíoblós
Sonvolaun=Sanúlán
Khunanpu=Cúnanpú
Amosis=Amósas
Harmonstown=Baile Hearman
ionnannas=ionannas
Epimetheus=Eipiméitéas
Memphis=Meimfís
Stentor=Steintear
treor=treoir
Grangemockler=Gráinseach Mhóicléir
Ballinraun=Baile an Ruáin
Dunmore=Dún Mór
Dernagree=Doire na Graí
Londonderry=Doire
Greenans=Na Grianáin
Glennamaddy=Gleann na Madadh
tearra=t-earra
Poulanargid=Poll an Airgid
Alcmene=Ailcméiné
Sami=Sáimis
Irishtown=An Baile Gaelach
Wesport=Cathair na Mart
asholáthar=a sholáthar
Kerry=Ciarraí
Fennagh=Fionnmhach
Slade=An Slaod
Cloghore=Cloich Óir
Westmeath=An Iarmhí
héinní=haon ní
Cootehall=Uachtar Thíre
Candlemas=Lá Fhéile Muire na gCoinneal
Iolaus=Ialás
Ballineen=Béal Átha Fhínín
Bucharest=Búcairist
Police=Garda Síochána
Kilclare=Coill an Chláir
Cameroons=Camarúin
Mozambique=Mósaimbíc
Mullagh=An Mullach
cuirdach=cuardach
contac=contae
Conghial=Conghail
Aughnasheelan=Achadh na Síleann
Araglin=Airglinn
seoagus=seo agus
Finea=Fiodh an Átha
Cashmere=An Chaismír
Templar=Teamplóir
Latteragh=Leatracha
Gleneask=Gleann Iasc
Glendalough=Gleann dá Loch
Castleleiney=Caisleán Laighnigh
Clonbulloge=Cluain Bolg
Orient=Oirthear
Avaris=Avaras
Sammarinese=San Mairíneach
Olympiad=Oilimpiad
Ballincurrig=Baile an Churraigh
Templeorum=Teampall Fhothram
Newry=Iúr Chinn Trá
Scottish=Na hAlbanaigh
Rótón=Rólón
Maynooth=Maigh Nuad
Hathor=Határ
Gurmukhi=Gurmúcaí
Finny=Fionnaithe
Corraneary=Corr an Aoire
Iberia=An Ibéir
Drumacrib=Droim Mhic Roib
Tobinstown=Baile Tóibín
Draco=Dragan
Houy=Húí
Brahman=Bráman
Islandbridge=Droichead na hInse
tráthclár=tráthchlár
Cummer=Comar
Lima=Líoma
Whitegate=An Geata Bán
Cloghmore=An Chloich Mhóir
speisealta=speisialta
Graniamore=Gráinne Mór
Crookstown=An Baile Gallda
Leamlara=Léim Lára
Alps=Alpa|Na hAlpa
isfearr=is fearr
Passionist=Páiseadóir
Farranhavane=Fearann Uí Chiabháin
Leap=An Léim
Creaghanroe=Crícheán Rua
September=Meán Fómhair|Mí Mheán Fómhair
deanam=déanamh
Faustalus=Fástalas
Christ=Críost
Tawnylea=Tamhnaí Liatha
Rathtoe=Ráth Tó
Ares=Airéas|Airéis
Ymir=Ímir
Minoan=Mionóch
Williamstown=Baile Liam
Dunraymond=Dún Réamainn
Merrion=Muirfin
Dunany=Dún Áine
oiliúnt=oiliúint
Lackaroe=An Leaca Rua
Dromacummer=Drom an Chomair
Wikisource=Vicífhoinse
bfhuil=bhfuil
daois=d'aois
Montserrat=Montsarat
braonín=braonán
eilea=eile a
Odin=Óidin
iarriadh=iarraidh
Melanesia=An Mheilinéis
Knockalough=Cnoc an Locha
néirí=n-éirí
Ture=An tIúr
Taliban=Talaban
fresin=freisin
Muff=Magh
Graigue=An Ghráig
Ballsbridge=Drochead na Dothra
Khons=Cons
Mullincross=Muileann Cros
Zagreb=Ságrab
Normandy=An Normainn
Geb=Geib
Kilbrackan=Coill Bhreacán
Mulhuddart=Mullach Eadrad
Moravia=An Mhoráiv
Wiktionary=Vicífhoclóir
compléasc=coimpléasc
tríthí=trithí|tríthi
sanáireamh=san áireamh
Dunleer=Dún Léire
Camross=Camros
Hebrides=Inse Ghall
Inishfree=Inis Fraoigh
Kiev=Cív
Lurga=An Lorgain
Caribbean=An Mhuir Chairib
Killinaboy=Cill Iníne Baoith
tradisiún=traidisiún
Kildinan=Cill Daighnín
Thermodon=Tearmódón
Plow=Seisreach
Padua=Padova
Leucippe=Leocaipé
Oldtown=An Seanbhaile
Unionhall=Bréantrá
chuigan=chuig an
doman=domhan
Lacken=An Leacain
Rhodesia=An Róidéis
Farnanes=Na Fearnáin
Brasil=An Bhrasaíl
Ardcrony=Ard Cróine
Loughduff=An Lathaigh Dhubh
Castlegal=Caisle Geala
Kinsalebeg=Baile an Phoill
Minotaur=Míonótár
Tedavnet=Tigh Damhnata
Kashmir=An Chaismír
teilfís=teilifís
Quixote=Cíochótae
Denreenargan=Doirín Argan
Killurin=Cill Iúirín|Cill Liúráin
Aphrodite=Afradaíté
déanmh=déanamh
forim=foirm
Kvasir=Cuasair
Balder=Baldar
Zambezi=An tSaimbéis
Carraholly=Ceathrú Chalaidh
Screen=An Scrín
feidm=feidhm
Pyrenees=Na Piréiní
gairéadeach=gairéadach
Lekaun=An Leacán
Maghery=An Machaire
tháinigh=tháinig
Ulster=Cúige Uladh|Ulaidh
Shanvaus=An Seanmhás
Bunbrosna=Bun Brosnaí
Drummartin=Droim Máirtín
Sionnaine=Sionainne
Rhineland=Dúiche na Réine
taon=t-aon
Roonagh=Rú an Átha
Cromane=An Cromán
Annagassan=Áth na gCasán
Grange=An Ghráinseach
Toem=Tuaim
Eurystheus=Eoraistéas
bfheidir=b'fhéidir
Grangebellew=Gráinseach an Dísirt
carráid=earráid
Eurovision=Eoraifís
thángas=thángthas
Ballinure=Baile an Iúir
bliaintúil=bliantúil
Selloo=Suí Lú
Flanders=Flóndras
neascleanúint=nascleanúint
Rathkea=Ráth Cae
Aetolia=Aetóil
Toor=An Tuar
Scardaun=Scardán
noibríonn=n-oibríonn
maidirleis=maidir leis
Alsace=An Alsáis
Tibet=An Tibéid
Antilles=Aintillí|Na hAintillí
bfuil=bhfuil
Levally=An Leathbhaile
aigesan=aigesean
Hellenic=Heilléinic
Commeen=An Coimín
Toornafulla=Tuar na Fola
Renaissance=Athbheochan
leathanch=leathanach
Audumla=Ódamla
Requiem=Aifreann na marbh|Aifreann éagnairce
Lombardy=An Lombaird
Saturnalia=Féile Satairn
Celebes=An Cheilibéis|An tSulaivéis
Welsh=Breatnaigh
Suttung=Sutang
Nicippe=Nicipé
Bweeng=Na Boinn
Corrandulla=Cor an Dola
Beglieve=Beagshliabh
Coan=An Cuan
Haulbowline=Inis Sionnach
Andes=Na hAindéis
Menkaure=Meancabhra
Wikipedia=Vicipéid
Kyoto=Kiótó
Readypenny=Cillín Cúile
agusa=agus a
greanmhar=greannmhar
feistisí=feisteas
Bunnanaddan=Bun an Fheadáin
Christianity=Críostaíocht|Críostúlacht
Kilberry=Cill Bhearaigh
Zion=Sión
dho=dó
Crusades=Cogaí na Croise
Lackamore=An Leaca Mhór
ainneoinn=ainneoin
Gailege=Gaeilge
Sarajevo=Sairéavó
praicticiúil=praiticiúil
nahÉireann=na hÉireann
Catslecor=Caisleán na Cora
Kilfree=Cill Fraoigh
Belderg=Béal Deirg
talt=t-alt
Lahardaun=Leathardán
Prometheus=Proiméitéas
Glenvar=Gleann Bhairr
Abderus=Aibdéireas
Shaker=Séicire
Dromore=An Droim Mór
Maori=Maorach
Inver=Inbhear
Knockrath=Cnoc Rátha
Clonrohid=Cluain Droichead
inúchadh=iniúchadh
dechuid=de chuid
Croesus=Créasas
Neale=An Éill
Drommahane=Drom Átháin
Ventry=Ceann Trá
Hebe=Héibé
tairscint=tairiscint
Raheens=Na Ráithíní
agom=agam
Hogmanay=Oíche Chinn Bhliana
difiriúla=difriúla
Killaloe=Cill Dalua
Kilnagross=Coill na gCros
fritheadh=fuarthas
Ossetia=Óiséit
measín=meaisín
Glooskap=Glúscap
Kilmeage=Cill Maodhóg
Romany=Romanaí
Sulawesi=An tSulaivéis
teaglach=teaghlach
Drumkeen=Droim Caoin
Turkmenia=An Tuircméanastáin
Burgundy=An Bhurgúin
Ferns=Fearna
Mantua=An Móinteach
isiad=is iad
Bible=Bíobla
Tarbert=Tairbeart
Congo=An Congó|Poblacht an Chongó
Gusserane=Ráth na gCosarán
Inishbofin=Inis Bó Finne
taistriúchán=t-aistriúchán
caiteamh=caitheamh
gaeilge=Gaeilge
Kilfinnane=Cill Fhíonáin
Oldcastle=An Seanchaisleán
tairgead=t-airgead
Farranree=Fearann an Rí
radh=rá
beagánín=beagáinín
mait=maith
Timbuktu=Timbeactú
Shantonagh=Seantonnach
Martín=Máirtín
gombeidh=go mbeidh
Hermes=Heirméas
maidirle=maidir le
Ahascragh=Áth Eascrach
Cliffony=Cliafuine
Baily=Dún Criofainn
Annacarty=Áth na Cairte
Salthill=Bóthar na Trá
dfhéidfeadh=d'fhéadfadh
dhaidh=dhiaidh
Bishopstown=Baile an Easpaig
Maccabee=Macabaech
Brownie=Brídín
Pict=Piocht
Thoueris=Túiris
Mullinacuff=Muileann Mhic Dhuibh
toileán=t-oileán
Curragh=An Currach
Bealaclugga=Béal an Chloga
Farran=An Fearann
Oeneus=Éinéas
Olympia=Oilimpia
Peloponnese=An Pheilipinéis
Assyria=An Aisiria
Napoléon=Napóilean
Corrib=Coirib
achmhainní=acmhainní
Burnfort=Ráth an Tóiteáin
Deianeira=Déinéire
Ballindrait=Baile an Droichid
Carlingford=Cairlinn
Passover=Cáisc
héireann=hÉireann
Sothis=Sótas
Rome=An Róimh
Athene=Aitéiné
ionnannais=ionannais
Loughmoe=Luachma
taispeán=taispeáin
Boru=Bóirmhe
Mithras=Mitreas
Lackan=An Leacain
Castlefreke=Ráth an Bharraigh
Australasia=An Astraláise
December=Mí na Nollag|Nollaig
Gypsy=Romanaí
Ballinglen=Baile an Ghleanna
God=An Fear Thuas|Dia
Pharaoh=Faró|Forann
nuir=nuair
Fardrum=Fardroim
dognaím=dogmaím
augs=agus
taitheantas=t-aitheantas
Java=Iáva
Moira=Móire
meánscolaí=meánscolaíocht
Doonaha=Dún Átha
seoa=seo a
Innisfail=Inis Fáil
Avoca=Abhóca
Portnoo=Port Nua
Garinish=Garinis
Chaldea=Caildé
Muhamad=Mahamad
Innfield=An Bóthar Buí
brioscáinphrátaí=brioscáin phrátaí
n'éirí=n-éirí
mease=measc
Kilmainham=Cill Mhaighneann
Uranus=Úránas
Asphodelus=Asfadal
saoriseoir=saoririseoir
Bunnacurry=Bun an Churraigh
tiocfadh=thiocfadh
daignithe=daingnithe
Scotland=Albain
Gaelge=Gaeilge
Bethlehem=An Bheithil
Helvetia=An Eilvéis
stráinséar=strainséir
Blacksod=An Fód Dubh
gobhfuil=go bhfuil
Tuscany=An Tuscáin|Toscana
Culfadda=Coill Fhada
Pythean=Píotach
Lehinch=An Leacht
Minorca=Mionarca
Nebamun=Neibeamún
Howth=Binn Éadair
Angelus=Fáilte an Aingil
Killinkere=Cillín Chéir
Sthenelus=Steinileas
Piraeus=Pioraes
sóchmhainní=sócmhainní
Minerva=Mineirve
Miltown=Baile an Mhuilinn
síochán=síocháin
May=Bealtaine|Mí na Bealtaine
Kilchreest=Cill Chríost
Christmastide=Nollaig
Taur=Teamhair
churchun=chur chun
Czechoslovakia=An tSeicslóvaic
Bhoston=Bhostún
Ceres=Ceiréas
Lettermullan=Leitir Mealláin
Tullylease=Tulach Léis
Hesperus=Réalta Nóna
Virginia=Achadh an Iúir|Virgín
Kincon=Cionn Con
Pisces=Éisc
Clonfinlough=Cluain Fionnlocha
Arabian=Arabach
Karnak=Carnac
Drumcask=Droim Cásca
Brittany=An Bhriotáin
eacnamíocht=eacnamaíocht
Border=Teorainn
Checkpoint=Pointe na Síge
Orchardton=Baile an Úlloird
Lapland=An Laplainn
Curraguneen=Currach Guinín
Urlaur=Urlár
isí=is í
Caledonia=Caladóin
Tagheen=Teach Chaoin
Satan=An Boc Dubh|An Fear Mór|An Fear Thíos|An Giolla Goillín|An Mac Mallachta|An Seanbhoc|An Seanbhuachaill|An buachaill críonna|An fear dubh|An tAinspiorad|An tÁibhirseoir|Fear an Uabhair
Twomileborris=Buiríos Léith
Aghabog=Achadh Bog
ecstais=eacstais
Templemartin=Teampall Mártan
Aghatubrid=Achadh Tiobraid
Balrath=Baile na Rátha
Clonskeagh=Cluain Sceach
Callownamuck=Caladh na Muc
saigdiúirí=saighdiúirí
Silveracre=Acra an Airgid
Corcreeghagh=An Chorr Chríochach
reáchtá=reáchtáil
Triangulum=Triantán
Attica=Aitice
nealaíon=n-ealaíon
síntús=síntiús
amhráinní=amhráin
Kilsallagh=Coill Salach
Treasury=Státchiste
Mnnivea=Muine Mheá
Rathluirc=An Ráth
Dunglow=An Clochán Liath
Anubis=Anúbas
Killea=Cill Shléibhe
Greenland=An Ghraonlainn
Mountlucas=Droim Cáithe
feicéal=feiceáil
Twomilehouse=Teach an dá Mhíle
Feohanagh=An Fheothanach
Gubaveeny=Gob an Mhianaigh
Kilmacanoge=Cill Mocheanóg
Abkhaz=An Abcáis
Robinstown=Baile Roibín
Turkmen=An Tuircméanastáin
Rathmore=An Ráth Mhór
Irishman=Gael
Donoghmore=Domhnach Mór
Gaelic=Gaeilge na hAlban
Puckaun=Pocán
sainiúl=sainiúil
tángadar=thángadar
Kilsallaghan=Cill Shalcháin
Alcoran=Córan
ionnanais=ionannais
Hanoi=Hanáí
Bunnahowen=Bun na hAbhna
Killoscully=Cill Ó Scolaí
t'fhios=tá a fhios
an-dheas=an-deas
sabhliain=sa bhliain
Habháí=Haváí
bliaina=bliana
Udmurt=Udmairt
Firbolgs=Fir Bolg
Spáinis=Spáinnis
Yemen=Éimin
Cranny=An Chrannaigh
Anglophone=Béarlóir
Kabardino-Balkaria=Cabairdín-Bhalcáir
Culkeeny=Cúil Chaonaigh
Gibraltar=Giobráltar
Hekat=Heiceat
aistriúchá=aistriúchán
Polaris=An Réalta Thuaidh
cile=eile
Beauparc=Baile Phaghain
Marshalstown=Baile Mharascail
Kiltullagh=Cill Tulach
iniúcadh=iniúchadh
Iphitus=Ífiteas
Corroy=Corr Ráithe
Astee=Eas Daoi
Slieveroe=Sliabh Rua
Castlejordan=Caisleán Shiurdáin
Ringsend=An Rinn
Balyglass=An Baile Glas
Speaker=Ceann Comhairle
Cloghran=Clochrán
díogras=díograis
achur=a chur
athrisím=aithrisím
Ratharney=Rath Fhearna
Calypso=Cailíopsó
Doogary=An Dúgharraí
Knockanevin=Cnocán Aoibhinn
igcrích=i gcrích
Idumea=An Iodúimé
Shannakae=Seanachae
Keadew=Céideadh
Gemini=Cúpla
mismím=mismín
túrscéal=t-úrscéal
coimpléasach=coimpléascach
Teye=Téighe
Walderstown=Baile Bháltair
Eastertide=Cáisc
Niasaland=An Niasalainn
agas=agus
Rathmoyle=An Ráth Mhaol
sóchmhainn=sócmhainn
Desertserges=An Díseart
Johnstown=Baile Eoin|Baile Sheáin|Cill Sheanaigh
Screggan=An Screagán
Garryhill=An Gharbhchoill
Carrick=An Charraig
Carragh=Ceárach
Meelin=An Mhaoilinn
Ballintober=Baile an Tobair
Clonlost=Cluain Loiste
Ballinameen=Béal an Átha Mín
Coachford=Áth an Chóiste
Roebuck=Reabóg
taire=tAire
Kilcotty=Cill Chota
c'ainm=cén t-ainm
a'bhfuil=an bhfuil
Lenamore=An Léana Mór
madir=maidir
Clonea=Cluain Fhia
Kindrum=Cionn Droma
Tibohine=Tigh Baoithín
arsan=arsa an
Tulla=An Tulach
aineoin=ainneoin
compháirtíocht=comhpháirtíocht
July=Iúil|Mí Iúil
guid=gcuid
Dnieper=An Dnípir
Corsica=An Chorsaic
Mallaranny=An Mhala Raithní
rómhnic=rómhinic
Carradoan=Ceathrú Domhain
Gaeilgoirí=Gaeilgeoirí
Glasnevin=Glasnaíon
abhfuil=a bhfuil
Galicia=An Ghailís
t'mé=tá mé
Tullynahinnera=Tulaigh na hInneora
Dunsany=Dún Samhnaí
Croom=Cromadh
Asia=An Áise
Celadon=Cheileadóin
Aghavas=Achadh an Mheasa
Newtownsandes=Maigh Mheáin
Glencairn=Baile an Gharráin
dféidfeadh=d'fhéadfadh
Nemesis=Neimisis
Whitechurch=An Teampall Geal
Portlaoise=Port Laoise
Crosspatrick=Crois Phádraig
teaghmháil=teagmháil
Svein=Sveidhn
Doon=Dún
Kill=An Chill
Meenlaragh=Mín Lárach
noileán=n-oileán
Gortatlea=Gort an tSléibhe
turlabhraí=t-urlabhraí
Calydon=Caladón
Ballingarry=Baile an Gharraí
Wolfhill=Cnocán na Mactíre
Gaybrook=Baile Réamainn
Dalmatia=An Dalmáit
comhgairdeas=comhghairdeas
Manulla=Maigh Nulla
Dunaff=Dún Damh
Fivemilebourne=Abhainn an Chartúin
Tooms=Tuaim
Iarchonnachta=Iar-Chonnachta
Repeal=Reipéil
Grenagh=Greanach
Camolin=Cam Eolaing
Sneferu=Sneifearú
Glenealy=Gleann Fhaidhle
Paibes=Péibéas
Owenbeg=An Abhainn Bheag
Knockanarrigan=Cnoc an Aragain
dfhonn=d'fhonn
Ower=Odhar
Teevurcher=Taobh Urchair
ilgnéitheach=ilghnéitheach
Darndale=Darndál
aonduine=aon duine
Aghadown=Achadh Dúin
Thanksgiving=Lá an Altaithe
Ulstermen=Ulaidh|Ultaibh
chualthas=chualathas
Kilkerrin=Cill Choirín
Knockatallan=Cnoc an tSalainn
Shronowen=Srón Abhann
thainic=tháinig
Agamemnon=Agaimeimneon
ainmeacha=ainmneacha
lompar=iompar
Burnfoot=Bun na hAbhann
Patagonia=An Phatagóin
Gneevgullia=Gníomh go Leith
ginerálta=ginearálta
Imhotep=Imeotap
Inishbiggle=Inis Bigil
Breaghwy=Bréachmhaigh
O'Callaghansmills=Muileann Uí Cheallacháin
Upperchurch=An Teampall Uachtarach
Killinick=Cill Fhionnóg
igcomhar=i gcomhar
Northlands=An Táchairt Thuaidh
Garadice=Garairis|Garbhros
Chaffpool=Loch na Cáithe
Craggach=An Chreagach
éireann=Éireann
fadbh=fadhb
Trent=Trionta
imhe=inmhe
Gaggan=Géagánach
Tagoat=Teach Gót
Hollowtide=Samhain
Achilles=Aichill|Aicilléas
aghlacadh=a ghlacadh
Rathcabban=Ráth Cabáin
Pole=Mol
Septuagesima=Seaptuaigéas
Mediterranean=An Mheánmhuir
Bermudas=Na Beirmiúdaí
Curacao=Curasao
dfhéadfadh=d'fhéadfadh
Dring=Droing
bhful=bhfuil
Drimoleague=Drom dhá Liag
chomhmaith=chomh maith
Skeaghvasteen=Sceach an Mhaistín
aimn=ainm
Ballinafad=Béal an Átha Fada
tarringím=tarraingím
Asgard=Ascar
Leghorn=Leigearn
Sardinia=An tSairdín
gairthí=ghairtí
Kildorragh=Coill Dorcha
Africa=An Afraic
Oceania=An Aigéine
Woodford=An Ghráig
Bacchus=Bacais|Bacas
Phoebus=Féabas
tionad=t-ionad
Galatia=An Ghaláit
Aretus=Airéiteas
socraid=sochraid
Psyche=Sícé
Kilmead=Cill Míde
Davidstown=Baile Dháith
stratéis=straitéis
Knockalisheen=Cnoc an Lisín
Cavangarden=Cabhán an Gharraí
Carrowkeel=An Cheathrú Chaol
codhladh=codladh
Sabbatarian=Sabóidire
Buddhist=Búdaí
Thracia=An Tráicia
frid=tríd
Augeas=Áigéas|Áigéis
deontaisi=deontais
Owning=Ónainn
Tahilla=Tathuile
Gattabaun=An Geata Bán
cadiad=cad iad
November=Samhain
Crucifixion=Céasadh
díobhse=díobhsan
Turkestan=An Turcastáin
Monaster=An Mhainistir
críchcanna=críocha
Clonbern=Cluain Bheirn
Redhills=An Cnoc Rua
profisiúnta=proifisiúnta
Ardmore=Aird Mhór
Buttevant=Cill na Mallach
Portnablaha=Port na Bláiche
Connemara=Conamara
Nereid=Néiriad
téan=t-éan
Portsalon=Port an tSalainn
Killeenadeema=Cillín a Díoma
tuairiscthe=tuairiscithe
arist=arís
Bistones=Biostónaigh
Aries=Reithe
Gleneely=Gleann Daoile
spesialta=speisialta
Anthesteria=Antaistéiria
deréir=de réir
nóa=nó a
Tang=An Teanga
feicáil=feiceáil
Evenor=Eiveanóir
Carlanstown=Droichead Chearbhalláin
Pollatomish=Poll an Tómais
grinneal=grinneall
Croghan=Cruachán
Midwest=Meán-Iarthar
Orpheus=Oirféas
moráis=mór-ais
Communion=Comaoin
Pythia=Pitia
Scartaglen=Scairteach an Ghlinne
Tacatus=Tacatas
Aughrim=Eachroim
Dardanelles=An Dardainéil
Tantalus=Tantalas
oired=oiread
t'eh=tá sé
Bonalas=Bothailios
Glenderry=Gleann Doire
Kilmurry=Cill Mhuire
Whitsuntide=An Chincís
diploma=dioplóma
Vulgate=Vulgáid
sochreite=sochreidte
naghaidh=n-aghaidh
Attanagh=Áth Tanaí
Kilmactranny=Cill Mhic Treana
leannúint=leanúint
Newtownshandrum=Baile Nua Sheandroma
Lammas=Lá Lúnasa
Midfield=An Trian Láir
niliomad=n-iliomad
raib=raibh
griain=grian
Euridanus=Eoradánas
Buddha=Búda
riomphost=ríomhphost
Catalonia=An Chatalóin
Aeneid=Aeniad
Killour=Cill Odhar
Devanagari=Déiveanágraí
Jesus=Íosa
idtaobh=i dtaobh
amáin=amháin
leathnach=leathanach
Corlough=Corlach
Carrowbeg=An Cheathrú Bheag
tuarim=tuairim
mionshonra=mionsonra
Garranard=Garrán Ard
Linus=Lineas
agua=agus
arlíne=ar líne
Westport=Cathair na Mart
Runnaroddan=Roinn an Rodáin
Fethard=Fiodh Ard
Scramoge=Scramóg
Madrid=Maidrid
Zaire=An tSáír|Poblacht Dhaonlathach an Chongó
teatarc=teatrarc
Exchequer=Státchiste
brothal=brothall
Aghacashel=Achadh an Chaisil
Oilgate=Maolán nGabhar
anchabhrach=an-chabhrach
Boeotia=An Bhéóitia
comairle=comhairle
Toomard=Tuaim Ard
Cheiron=Céarón
trím=trí mo
ostán=óstlann
céadatán=céatadán
aistharraingt=aistarraingt
Kampuchea=An Champúis
Lough=Loch
Hestia=Heistia
teolas=t-eolas
eacnamíochta=eacnamaíochta
Lathnamard=Leacht na mBard
aineoinn=ainneoin
déanam=déanamh
